############################################################
#       #                      #     #           #         #
#  1    #      !               #                   #   &   #
#       ######     ## ##       #     #              #      #
#            ######     ########     #########       #     #
#       #                            #       #       #     #
##### ########                ###########     #     #      #
# !      2   ####### ####     #         #      #           #
#            #  !       #      #       #        #   #      #
############################################################