############################################################
#       #    !                 #     #       !   #         #
#  1    #                      #     &            ##   ?   #
#       ######     ##&##       #     #              #      #
#  !    &    ######     ########     #########       #     #
#       #                            #       #       #     #
#####&########                ###########     #     #      #
#        2   ####### ####     #         #      #    &      #
#   !        #   !      #      #       #        #   #      #
############################################################